########################################
#......................................#
#......#####.............###########...#
#......#...#.............#.........#...#
#......#.................#######...#...#
#......#...#...................##.##...#
#......#...#...........................#
#......#####...........................#
#......................................#
#......................................#
#..........................########....#
#.......##########.........#......#....#
#.......#........#.........#......#....#
#.......#........#................######
#................#.........#...........#
#.......#........#.........#...........#
#.......#........#.........####........#
#.......##########............#........#
#.............................##########
#......................................#
#......................................#
#...............###.############.......#
#...............#..............#.......#
#...............#..............#.......#
########################################
