#################################
#...............................#
#......#####....................#
#......#...#....................#
#......#........................#
#......#...#....................#
#......#...#....................#
#......#####....................#
#...............................#
#...............###.#############
#...............#...............#
#...............#...............#
#################################
